{
  "background": "/assets/maps/map_one_background.png",
  "start_position": {
    "x": 0,
    "y": 5
  },
  "end_position": {
    "x": 14,
    "y": 15
  },
  "map_matrix": [
    [0, 0, 0, 0, 0, 0, 0, 0, 0, 0, 0, 0, 0, 0, 0, 0, 0, 0, 0, 0],
    [0, 0, 0, 0, 2, 0, 0, 0, 0, 0, 0, 0, 0, 0, 0, 0, 0, 0, 0, 0],
    [0, 0, 0, 0, 0, 0, 0, 0, 0, 0, 0, 0, 0, 0, 0, 2, 0, 0, 0, 0],
    [0, 0, 1, 1, 1, 1, 0, 0, 0, 1, 1, 1, 0, 0, 0, 0, 0, 0, 0, 0],
    [0, 2, 1, 0, 0, 1, 0, 2, 0, 1, 0, 1, 1, 0, 0, 0, 0, 0, 0, 0],
    [1, 1, 1, 0, 0, 1, 0, 0, 1, 1, 0, 0, 1, 2, 0, 0, 0, 0, 0, 0],
    [0, 0, 2, 0, 0, 1, 2, 0, 1, 0, 2, 2, 1, 1, 1, 0, 0, 0, 0, 0],
    [0, 0, 0, 0, 0, 1, 0, 0, 1, 0, 2, 2, 0, 0, 1, 0, 0, 0, 0, 0],
    [0, 2, 0, 0, 0, 1, 0, 0, 1, 1, 0, 0, 0, 0, 1, 0, 0, 0, 0, 0],
    [0, 0, 0, 1, 1, 1, 0, 0, 0, 1, 0, 0, 1, 1, 1, 0, 0, 0, 0, 0],
    [0, 0, 0, 1, 0, 0, 2, 1, 1, 1, 2, 0, 1, 2, 0, 0, 0, 0, 0, 0],
    [0, 0, 0, 1, 1, 0, 0, 1, 0, 0, 0, 0, 1, 0, 0, 0, 0, 0, 0, 0],
    [0, 0, 0, 0, 1, 1, 1, 1, 0, 0, 0, 0, 1, 0, 0, 0, 0, 0, 0, 0],
    [0, 2, 0, 0, 0, 0, 0, 0, 0, 0, 0, 0, 1, 0, 0, 2, 0, 0, 0, 0],
    [0, 0, 0, 0, 0, 0, 0, 0, 2, 0, 0, 0, 1, 1, 1, 0, 0, 0, 0, 0],
    [0, 0, 0, 0, 0, 0, 0, 0, 0, 0, 0, 0, 2, 0, 1, 0, 0, 0, 0, 0]

  ]
}