{
  "start_position": {
    "x": 0,
    "y": 5
  },
  "end_position": {
    "x": 14,
    "y": 15
  },
  "map_matrix": [
    [0, 0, 0, 0, 0, 6, 0, 0, 0, 0, 0, 0, 0, 0, 6, 0, 0, 0, 0, 0],
    [0, 0, 0, 7, 0, 0, 0, 0, 7, 0, 0, 0, 7, 0, 0, 0, 0, 0, 0, 0],
    [0, 0, 0, 0, 0, 0, 0, 0, 0, 0, 0, 0, 0, 6, 0, 0, 6, 0, 0, 0],
    [0, 0, 1, 1, 1, 1, 6, 0, 0, 1, 1, 1, 0, 0, 0, 0, 0, 0, 0, 0],
    [0, 6, 1, 8, 8, 1, 0, 0, 0, 1, 0, 1, 1, 0, 0, 7, 0, 0, 0, 0],
    [1, 1, 1, 0, 0, 1, 0, 0, 1, 1, 8, 0, 1, 0, 0, 0, 0, 6, 0, 0],
    [0, 6, 0, 0, 0, 1, 0, 0, 1, 0, 2, 3, 1, 1, 1, 0, 0, 0, 0, 0],
    [0, 0, 0, 0, 0, 1, 0, 0, 1, 0, 4, 5, 0, 0, 1, 6, 0, 0, 0, 0],
    [0, 0, 0, 0, 0, 1, 0, 0, 1, 1, 0, 0, 0, 0, 1, 0, 0, 0, 0, 0],
    [0, 0, 0, 1, 1, 1, 7, 0, 0, 1, 0, 0, 1, 1, 1, 0, 8, 0, 0, 0],
    [0, 0, 0, 1, 0, 0, 0, 1, 1, 1, 0, 0, 1, 0, 0, 0, 0, 0, 0, 0],
    [0, 0, 0, 1, 1, 0, 0, 1, 0, 0, 0, 0, 1, 7, 0, 0, 0, 0, 0, 0],
    [0, 0, 0, 0, 1, 1, 1, 1, 0, 6, 0, 0, 1, 0, 0, 0, 0, 0, 0, 0],
    [0, 7, 0, 8, 0, 0, 0, 0, 0, 0, 0, 0, 1, 0, 8, 0, 6, 0, 0, 0],
    [0, 7, 0, 6, 0, 0, 0, 0, 0, 0, 0, 0, 1, 1, 1, 0, 0, 0, 0, 0],
    [0, 0, 0, 0, 0, 0, 0, 0, 0, 7, 0, 0, 0, 0, 1, 0, 0, 0, 0, 0]
  ]
}